        ########
        #     A#
        # @#@ ##
        # @  @#
        ##@ @ #
######### @ # ###
#oooo  ## @  @  #
##ooo    @  @   #
#oooo  ##########
########