#####
#A  #
# @@#
# oo#
#   #
#   #
#####