##########
##A#######
#        #
#  @     #
#        #
#  o     #
##########