#####
#A  #
#@@@#
#ooo#
#   #
#   #
#####